11111111111111111111111
10000000000100000000001
10111011101110011101101
10000000000000000000001
11110100000100000101111
00000100011111000100002
00000000010001000000003
00000100011111000100004
11110100000100000101111
10000000000000000000001
10111011101110111011101
10000000000100000000001
11111111111111111111111
